libros	l i b rf o s
para	p a rf a
doo	d o o
di	d i
bi	b i
queda	k e D a
en	e ng
el	e l
suelo	s w e l o
alguna	a l G u n a
sangre	s a n g rf e
abia	a b j a
goo	G o o
de	d e
gota	G o t a
gi	x i
daa	d a a
objetivos	o x e t i b o s
la	l a
línea	l i+ n e a
pobreza	p o b rf e s a
equidad	e k i D a
y	j
bienestar	b j e n e s t a rf
buscamos	b u s k a m o s
evaluacion	e b a l w a T j o n
información	i n f o rf m a T j o+ n
una	u n a
biblioteca	b i b l j o t e k a
gaa	G a a
boo	b o o
no	n o
veo	b e o
informacion	i n f o rf m a T j o n
un	u ng
caso	k a s o
estudio	e s t u D j o
comunidad	k o m u n i D a
madrid	m a D rf i
baa	b a a
